XXXXXXXXXXXX
X++__X_____XXX
X++__X_k__k__X
X++__XkXXXX__X
X++____s_XX__X
X++__X_X__k_XX
XXXXXX_XXk_k_X
  X_k__k_k_k_X
  X____X_____X
  XXXXXXXXXXXX