        XXXXXXXX
        X_____sX
        X_kXk_XX
        X_k__kX
        XXk_k_X
XXXXXXXXX_k_X_XXX
X++++__XX_k__k__X
XX+++____k__k___X
X++++__XXXXXXXXXX
XXXXXXXX