           XXXXXXXX
           X__++++X
XXXXXXXXXXXX__++++X
X____X__k_k___++++X
X_kkkXk__k_X__++++X
X__k_____k_X__++++X
X_kk_Xk_k_kXXXXXXXX
X__k_X_____X
XX_XXXXXXXXX
X____X____XX
X_____k___XX
X__kkXkk__sX
X____X____XX
XXXXXXXXXXX
