XXXXXXXXX
X_______X
X___+___X
X___+___X
X_______X
X___s___X
X_______X
X__XXX__X
X_kX Xk_X
X__X X__X
XXXX XXXX