XXXXXXXXXXX
X_________X
X_______k_X
X______XXXX
X_++Ks_X
X______XXXX
X_______k_X
X_________X
XXXXXXXXXXX